W W W W W W W
W _ _ G _ _ W
W _ U _ _ S W
W _ _ K _ _ W
W _ O _ D _ W
W _ _ _ _ E W
W W W W W W W
