W W W W W W W
W _ K G _ _ W
W _ U _ _ S W
W _ O _ K _ W
W _ D _ _ _ W
W _ _ _ _ E W
W W W W W W W
